# Special countries..
REB = "countries/vanilla/Rebels.txt"
PIR = "countries/vanilla/Pirates.txt"
NAT = "countries/vanilla/Natives.txt"
#Scandinavia
SWE = "countries/vanilla/Sweden.txt"
DAN = "countries/vanilla/Denmark.txt"
FIN = "countries/vanilla/Finland.txt"
GOT = "countries/vanilla/Gotland.txt"
NOR = "countries/vanilla/Norway.txt"
SHL = "countries/vanilla/Holstein.txt"
SCA = "countries/vanilla/Scandinavia.txt"
EST = "countries/vanilla/Estonia.txt"
LVA = "countries/vanilla/Livonia.txt"
LTG = "countries/vanilla/Latgalia.txt"
SMI = "countries/vanilla/Sami.txt"
KRL = "countries/vanilla/Karelia.txt"
ICE = "countries/vanilla/Iceland.txt"
#Balkans
ACH = "countries/vanilla/PrincipalityOfAchaia.txt"
ALB = "countries/vanilla/Albania.txt"
ATH = "countries/vanilla/Athens.txt"
BOS = "countries/vanilla/Bosnia.txt"
BUL = "countries/vanilla/Bulgaria.txt"
BYZ = "countries/vanilla/ByzantineEmpire.txt"
LAE = "countries/vanilla/Latin Empire.txt"
CEP = "countries/vanilla/Corfu.txt"
CRO = "countries/vanilla/Croatia.txt"
CRT = "countries/vanilla/Crete.txt"
CYP = "countries/vanilla/Cyprus.txt"
DAL = "countries/vanilla/Dalmatia.txt"
EPI = "countries/vanilla/Epirus.txt"
GRE = "countries/vanilla/Greece.txt"
KNI = "countries/vanilla/Knights.txt"
MOE = "countries/vanilla/Morea.txt"
MOL = "countries/vanilla/Moldavia.txt"
MON = "countries/vanilla/Montenegro.txt"
NAX = "countries/vanilla/Naxos.txt"
RAG = "countries/vanilla/Ragusa.txt"
RMN = "countries/vanilla/Romania.txt"
SER = "countries/vanilla/Serbia.txt"
TRA = "countries/vanilla/Transylvania.txt"
WAL = "countries/vanilla/Wallachia.txt"
HUN = "countries/vanilla/Hungary.txt"
SLO = "countries/vanilla/Slovakia.txt"
TUR = "countries/vanilla/Ottomans.txt"
#British Isles 
CNN = "countries/vanilla/Connacht.txt"
CRN = "countries/vanilla/Cornwall.txt"
ENG = "countries/vanilla/England.txt"
LEI = "countries/vanilla/Leinster.txt"
IRE = "countries/vanilla/Ireland.txt"
MNS = "countries/vanilla/IRE_Munster.txt"
SCO = "countries/vanilla/Scotland.txt"
TYR = "countries/vanilla/Tyrone.txt"
WLS = "countries/vanilla/Wales.txt"
NOL = "countries/vanilla/Northumberland.txt"
GBR = "countries/vanilla/GreatBritain.txt"
AVE = "countries/vanilla/AngevinEmpire.txt"
MTH = "countries/vanilla/Meath.txt"
ULS = "countries/vanilla/Ulster.txt"
DMS = "countries/vanilla/Desmond.txt"#Earldom of Desmond
SLN = "countries/vanilla/Sligo.txt"
KID = "countries/vanilla/Kildare.txt"
HSC = "countries/vanilla/Highlands.txt"
ORD = "countries/vanilla/Ormond.txt"
TRY = "countries/vanilla/Tyrconnell.txt"
FLY = "countries/vanilla/Faly.txt"
MCM = "countries/vanilla/MacCarthy.txt"#Kingdom of Desmond
KOI = "countries/vanilla/Mann.txt"
LOI = "countries/vanilla/TheIsles.txt"
EIC = "countries/vanilla/EastIndiaCompany.txt"
#Colonies
BRZ = "countries/vanilla/Brazil.txt"
CAN = "countries/vanilla/Canada.txt"
CHL = "countries/vanilla/Chile.txt"
COL = "countries/vanilla/Colombia.txt"
HAT = "countries/vanilla/Haiti.txt"
LAP = "countries/vanilla/LaPlata.txt"
LOU = "countries/vanilla/Louisiana.txt"
MEX = "countries/vanilla/Mexico.txt"
PEU = "countries/vanilla/Peru.txt"
PRG = "countries/vanilla/Paraguay.txt"
QUE = "countries/vanilla/Quebec.txt"
CAM = "countries/vanilla/UPCA.txt"
USA = "countries/vanilla/USA.txt"
VNZ = "countries/vanilla/Venezuela.txt"
AUS = "countries/vanilla/Australia.txt"
CAL = "countries/vanilla/California.txt"
TEX = "countries/vanilla/Texas.txt"
CSC = "countries/vanilla/Cascadia.txt"
ALA = "countries/vanilla/Alaska.txt"
NZL = "countries/vanilla/Zealandia.txt"
ILI = "countries/vanilla/Illinois.txt"
FLO = "countries/vanilla/Florida.txt"
VRM = "countries/vanilla/Vermont.txt"
SNA = "countries/vanilla/Sonora.txt"
WSI = "countries/vanilla/WestIndies.txt"
CUB = "countries/vanilla/Cuba.txt"
#Eastern Europe
DNZ = "countries/vanilla/Danzig.txt"
KRA = "countries/vanilla/Krakow.txt"
LIT = "countries/vanilla/Lithuania.txt"
LIV = "countries/vanilla/LivonianOrder.txt"
MAZ = "countries/vanilla/Mazovia.txt"
POL = "countries/vanilla/Poland.txt"
PRU = "countries/vanilla/Prussia.txt"
KUR = "countries/vanilla/Kurland.txt"
RIG = "countries/vanilla/Riga.txt"
TEU = "countries/vanilla/Teutonicorder.txt"
PLC = "countries/vanilla/TheCommonwealth.txt"
VOL = "countries/vanilla/Volyn.txt"
KIE = "countries/vanilla/Kiev.txt"
CHR = "countries/vanilla/Chernigov.txt"
OKA = "countries/vanilla/Oka.txt"
#France 
ALE = "countries/vanilla/Alencon.txt"
ALS = "countries/vanilla/Alsace.txt"
AMG = "countries/vanilla/Armagnac.txt"
AUV = "countries/vanilla/Auvergne.txt"
AVI = "countries/vanilla/Avignon.txt"
BOU = "countries/vanilla/Bourbonnais.txt"
BRI = "countries/vanilla/Brittany.txt"
BUR = "countries/vanilla/Burgundy.txt"
CHP = "countries/vanilla/Champagne.txt"
COR = "countries/vanilla/Corsica.txt"
DAU = "countries/vanilla/Dauphine.txt"
FOI = "countries/vanilla/Foix.txt"
FRA = "countries/vanilla/France.txt"
GUY = "countries/vanilla/Gascony.txt"
NEV = "countries/vanilla/Nevers.txt"
NRM = "countries/vanilla/Normandy.txt"
ORL = "countries/vanilla/Orleans.txt"
PIC = "countries/vanilla/Picardy.txt"
PRO = "countries/vanilla/Provence.txt"
SPI = "countries/vanilla/SardiniaPiedmont.txt"
TOU = "countries/vanilla/Toulouse.txt"
BER = "countries/vanilla/Berry.txt"
#HRE
AAC = "countries/vanilla/Aachen.txt"
ANH = "countries/vanilla/Anhalt.txt"
ANS = "countries/vanilla/Ansbach.txt"
AUG = "countries/vanilla/Augsburg.txt"
BAD = "countries/vanilla/Baden.txt"
BAV = "countries/vanilla/Bavaria.txt"
BOH = "countries/vanilla/Bohemia.txt"
BRA = "countries/vanilla/Brandenburg.txt"
BRE = "countries/vanilla/Bremen.txt"
BRU = "countries/vanilla/Brunswick.txt"
EFR = "countries/vanilla/EastFrisia.txt"
FRN = "countries/vanilla/Frankfurt.txt"
GER = "countries/vanilla/Germany.txt"
HAB = "countries/vanilla/Austria.txt"
HAM = "countries/vanilla/Hamburg.txt"
HAN = "countries/vanilla/Hannover.txt"
HES = "countries/vanilla/Hessen.txt"
HLR = "countries/vanilla/HolyRomanEmpire.txt"
KLE = "countries/vanilla/Kleves.txt"
KOL = "countries/vanilla/Cologne.txt"
LAU = "countries/vanilla/Lauenburg.txt"
LOR = "countries/vanilla/Lorraine.txt"
LUN = "countries/vanilla/Luneburg.txt"
MAG = "countries/vanilla/Magdeburg.txt"
MAI = "countries/vanilla/Mainz.txt"
MEI = "countries/vanilla/Meissen.txt"
MKL = "countries/vanilla/Mecklenburg.txt"
MUN = "countries/vanilla/Munster.txt"
MVA = "countries/vanilla/Moravia.txt"
OLD = "countries/vanilla/Oldenburg.txt"
PAL = "countries/vanilla/Palatinate.txt"
POM = "countries/vanilla/Pommerania.txt"
SAX = "countries/vanilla/Saxony.txt"
SIL = "countries/vanilla/Silesia.txt"
SLZ = "countries/vanilla/Salzburg.txt"
STY = "countries/vanilla/Styria.txt"
SWI = "countries/vanilla/Schweiz.txt"
THU = "countries/vanilla/Thuringia.txt"
TIR = "countries/vanilla/Tirol.txt"
TRI = "countries/vanilla/Trier.txt"
ULM = "countries/vanilla/Ulm.txt"
WBG = "countries/vanilla/Wurzburg.txt"
WES = "countries/vanilla/Westfalia.txt"
WUR = "countries/vanilla/Wurttemberg.txt"
NUM = "countries/vanilla/Nuremberg.txt"
MEM = "countries/vanilla/Memmingen.txt"
VER = "countries/vanilla/Verden.txt"
NSA = "countries/vanilla/Nassau.txt"
RVA = "countries/vanilla/Ravensburg.txt"
DTT = "countries/vanilla/Dithmarschen.txt"
#Spain
ARA = "countries/vanilla/Aragon.txt"
CAS = "countries/vanilla/Castille.txt"
CAT = "countries/vanilla/Catalunya.txt"
GRA = "countries/vanilla/Granada.txt"
NAV = "countries/vanilla/Navarra.txt"
POR = "countries/vanilla/Portugal.txt"
SPA = "countries/vanilla/Spain.txt"
GAL = "countries/vanilla/Galicia.txt"
LON = "countries/vanilla/Leon.txt"
ADU = "countries/vanilla/Andalusia.txt"
VAL = "countries/vanilla/Valencia.txt"
ASU = "countries/vanilla/Asturias.txt"
MJO = "countries/vanilla/Majorca.txt"
#Italy
AQU = "countries/vanilla/Aquileia.txt"
ETR = "countries/vanilla/Etruria.txt"
FER = "countries/vanilla/Ferrara.txt"
GEN = "countries/vanilla/Genoa.txt"
ITA = "countries/vanilla/Italy.txt"
MAN = "countries/vanilla/Mantua.txt"
MLO = "countries/vanilla/Milan.txt"
MOD = "countries/vanilla/Modena.txt"
NAP = "countries/vanilla/Naples.txt"
PAP = "countries/vanilla/Papal.txt"
PAR = "countries/vanilla/Parma.txt"
PIS = "countries/vanilla/Pisa.txt"
SAR = "countries/vanilla/Sardinia.txt"
SAV = "countries/vanilla/Savoy.txt"
SIC = "countries/vanilla/Sicily.txt"
SIE = "countries/vanilla/Siena.txt"
TUS = "countries/vanilla/Tuscany.txt"
URB = "countries/vanilla/Urbino.txt"
VEN = "countries/vanilla/Venice.txt"
MFA = "countries/vanilla/Montferrat.txt"
LUC = "countries/vanilla/Lucca.txt"
LAN = "countries/vanilla/Florence.txt"
JAI = "countries/vanilla/Malta.txt"
#Low Countries
BRB = "countries/vanilla/Brabant.txt"
FLA = "countries/vanilla/Flanders.txt"
FRI = "countries/vanilla/Friesland.txt"
GEL = "countries/vanilla/Gelre.txt"
HAI = "countries/vanilla/Hainaut.txt"
HOL = "countries/vanilla/Holland.txt"
LIE = "countries/vanilla/Liege.txt"
LUX = "countries/vanilla/Luxembourg.txt"
NED = "countries/vanilla/Netherlands.txt"
UTR = "countries/vanilla/Utrecht.txt"
#Russia 
ARM = "countries/vanilla/Armenia.txt"
AST = "countries/vanilla/Astrakhan.txt"
CRI = "countries/vanilla/Crimea.txt"
GEO = "countries/vanilla/Georgia.txt"
KAZ = "countries/vanilla/Kazan.txt"
MOS = "countries/vanilla/Muscowy.txt"
NOV = "countries/vanilla/Novgorod.txt"
PSK = "countries/vanilla/Pskov.txt"
QAS = "countries/vanilla/QasimKhanate.txt"
RUS = "countries/vanilla/Russia.txt"
RYA = "countries/vanilla/Ryazan.txt"
TVE = "countries/vanilla/Tver.txt"
UKR = "countries/vanilla/Ukraine.txt"
YAR = "countries/vanilla/Yaroslavl.txt"
ZAZ = "countries/vanilla/Zaporozhie.txt"
NOG = "countries/vanilla/Nogai.txt"
SIB = "countries/vanilla/Sibir.txt"
PLT = "countries/vanilla/Polotsk.txt"
PRM = "countries/vanilla/Perm.txt"
FEO = "countries/vanilla/Theodoro.txt"
BSH = "countries/vanilla/Bashkiria.txt"
BLO = "countries/vanilla/Beloozero.txt"
RSO = "countries/vanilla/Rostov.txt"
GOL = "countries/vanilla/GreatHorde.txt"
GLH = "countries/vanilla/GoldenHorde.txt"
#Arabia	
ADE = "countries/vanilla/Aden.txt"
ALH = "countries/vanilla/Haasa.txt"
ANZ = "countries/vanilla/Anizah.txt"
ARB = "countries/vanilla/Arabia.txt"
ARD = "countries/vanilla/Ardalan.txt"
BHT = "countries/vanilla/Bohtan.txt"
DAW = "countries/vanilla/Dawasir.txt"
ERE = "countries/vanilla/Eretna.txt"
FAD = "countries/vanilla/Fadl.txt"
GRM = "countries/vanilla/Germiyan.txt"
HDR = "countries/vanilla/Hadramut.txt"
HED = "countries/vanilla/Hedjaz.txt"
LEB = "countries/vanilla/Lebanon.txt"
MAK = "countries/vanilla/Makuria.txt"
MDA = "countries/vanilla/Medina.txt"
MFL = "countries/vanilla/Mikhlaf.txt"
MHR = "countries/vanilla/Mahra.txt"
NAJ = "countries/vanilla/Najd.txt"
NJR = "countries/vanilla/Najran.txt"
OMA = "countries/vanilla/Oman.txt"
RAS = "countries/vanilla/Rassids.txt"
SHM = "countries/vanilla/Shammar.txt"
SHR = "countries/vanilla/Sharjah.txt"
SRV = "countries/vanilla/Shirvanshah.txt"
YAS = "countries/vanilla/Yas.txt"
YEM = "countries/vanilla/Yemen.txt"
HSN = "countries/vanilla/Ayyubids.txt"
BTL = "countries/vanilla/Bitlis.txt"
#Asia Minor		
AKK = "countries/vanilla/AkKoyunlu.txt"
AYD = "countries/vanilla/Aydin.txt"
CND = "countries/vanilla/Candar.txt"
DUL = "countries/vanilla/Dulkadir.txt"
IRQ = "countries/vanilla/Iraq.txt"
KAR = "countries/vanilla/Karaman.txt"
SYR = "countries/vanilla/Syria.txt"
TRE = "countries/vanilla/Trebizond.txt"
SRU = "countries/vanilla/Saruhan.txt"
MEN = "countries/vanilla/Mentese.txt"
RAM = "countries/vanilla/Ramazan.txt"
AVR = "countries/vanilla/Avars.txt"
MLK = "countries/vanilla/Kashen.txt"
SME = "countries/vanilla/Samtskhe.txt"
ARL = "countries/vanilla/Ardabil.txt"
MSY = "countries/vanilla/Mushashaiyyah.txt"
RUM = "countries/vanilla/Rum.txt"
#Maghreb
ALG = "countries/vanilla/Algiers.txt"
FEZ = "countries/vanilla/Fez.txt"
MAM = "countries/vanilla/Burgi.txt"
MOR = "countries/vanilla/Morocco.txt"
TRP = "countries/vanilla/Tripoli.txt"
TUN = "countries/vanilla/Tunisia.txt"
EGY = "countries/vanilla/Egypt.txt"
KBA = "countries/vanilla/Kabylia.txt"
TFL = "countries/vanilla/Tafilalt.txt"
SOS = "countries/vanilla/Sus.txt"
TLC = "countries/vanilla/Tlemcen.txt"
TGT = "countries/vanilla/Touggourt.txt"
GHD = "countries/vanilla/Ghadames.txt"
FZA = "countries/vanilla/Fezzan.txt"
MZB = "countries/vanilla/Mzab.txt"
SLE = "countries/vanilla/Sale.txt"
TET = "countries/vanilla/Tetouan.txt"
MRK = "countries/vanilla/Marrakesh.txt"
#Central Asia
KZH = "countries/vanilla/Kazakh.txt"
KHI = "countries/vanilla/Khiva.txt"
SHY = "countries/vanilla/Shaybanid.txt"
KOK = "countries/vanilla/Kokkand.txt"
BUK = "countries/vanilla/Bukhara.txt"
#Persia	
AFG = "countries/vanilla/Afghanistan.txt"
KHO = "countries/vanilla/Khorasan.txt"
PER = "countries/vanilla/Persia.txt"
ERS = "countries/vanilla/Eranshahr.txt"
QAR = "countries/vanilla/QaraKoyunlu.txt"
TIM = "countries/vanilla/Timurid.txt"
TRS = "countries/vanilla/Transoxiana.txt"
KRY = "countries/vanilla/Gilan.txt"
CIR = "countries/vanilla/Circassia.txt"
GAZ = "countries/vanilla/Gazikumukh.txt"
IME = "countries/vanilla/Imereti.txt"
TAB = "countries/vanilla/Tabarestan.txt"
ORM = "countries/vanilla/Ormuz.txt"
LRI = "countries/vanilla/Luristan.txt"
SIS = "countries/vanilla/Sistan.txt"
BPI = "countries/vanilla/Biapas.txt"
FRS = "countries/vanilla/Fars.txt"
KRM = "countries/vanilla/Kerman.txt"
YZD = "countries/vanilla/Yazd.txt"
ISF = "countries/vanilla/Isfahan.txt"
TBR = "countries/vanilla/Tabriz.txt"
BSR = "countries/vanilla/Basra.txt"
MGR = "countries/vanilla/Maregh.txt"
QOM = "countries/vanilla/Qom.txt"
#Americas
AZT = "countries/vanilla/Aztec.txt"
CHE = "countries/vanilla/Cherokee.txt"
CHM = "countries/vanilla/Chimu.txt"
CRE = "countries/vanilla/Creek.txt"
HUR = "countries/vanilla/Huron.txt"
INC = "countries/vanilla/Inca.txt"
IRO = "countries/vanilla/Iroquois.txt"
MAY = "countries/vanilla/Maya.txt"
SHA = "countries/vanilla/Shawnee.txt"
ZAP = "countries/vanilla/Zapotec.txt"
#Africa
ASH = "countries/vanilla/Ashanti.txt"
BEN = "countries/vanilla/Benin.txt"
ETH = "countries/vanilla/Ethiopia.txt"
KON = "countries/vanilla/Kongo.txt"
MAL = "countries/vanilla/Mali.txt"
NUB = "countries/vanilla/Funj.txt"
SON = "countries/vanilla/Songhai.txt"
ZAN = "countries/vanilla/Swahili.txt"
ZIM = "countries/vanilla/Mutapa.txt"
ADA = "countries/vanilla/Adal.txt"
HAU = "countries/vanilla/Hausa.txt"
KBO = "countries/vanilla/KanemBornu.txt"
LOA = "countries/vanilla/Loango.txt"
OYO = "countries/vanilla/Oyo.txt"
SOF = "countries/vanilla/Sofala.txt"
SOK = "countries/vanilla/Sokoto.txt"
JOL = "countries/vanilla/Jolof.txt"
SFA = "countries/vanilla/SofalaSwa.txt"
MBA = "countries/vanilla/Mombasa.txt"
MLI = "countries/vanilla/Malindi.txt"
AJU = "countries/vanilla/Ajuuraan.txt"
MDI = "countries/vanilla/Mogadishu.txt"
ENA = "countries/vanilla/Eneara.txt"
WGD = "countries/vanilla/Wagadugu.txt"
ZND = "countries/vanilla/Zandoma.txt"
GUR = "countries/vanilla/Gurma.txt"
TEN = "countries/vanilla/Tenkodogo.txt"
OGD = "countries/vanilla/Ogaadeen.txt"
ZUL = "countries/vanilla/Zulu.txt"
SOM = "countries/vanilla/Somalia.txt"
AKS = "countries/vanilla/Aksumite Empire.txt"
GZI = "countries/vanilla/Great Zimbabwe.txt"
NBI = "countries/vanilla/Nubia.txt"
RZI = "countries/vanilla/Rozwi.txt"
KIT = "countries/vanilla/Kitara.txt"
WAD = "countries/vanilla/Wadai.txt"
#XHO = "countries/vanilla/Xhosa.txt"
#KBI = "countries/vanilla/Kebbi.txt"
#ZAM = "countries/vanilla/Zamfara.txt"
#GOB = "countries/vanilla/Gobir.txt"
#BIR = "countries/vanilla/Biram.txt"
#DAU = "countries/vanilla/Daura.txt"
#East African Additions
AFA = "countries/vanilla/Afar.txt"
ALO = "countries/vanilla/Alodia.txt"
DAR = "countries/vanilla/Darfur.txt"
GLE = "countries/vanilla/Geledi.txt"
HAR = "countries/vanilla/Harar.txt"
HOB = "countries/vanilla/Hobyo.txt"
KAF = "countries/vanilla/Kaffa.txt"
MED = "countries/vanilla/Medri Bahri.txt"
MJE = "countries/vanilla/Majeerteen.txt"
MRE = "countries/vanilla/Marehan.txt"
PTE = "countries/vanilla/Pate.txt"
WAR = "countries/vanilla/Warsangali.txt"
BTI = "countries/vanilla/Semien.txt"
BEJ = "countries/vanilla/Beja.txt"
JIM = "countries/vanilla/Jima.txt"
WLY = "countries/vanilla/Welayta.txt"
DAM = "countries/vanilla/Damot.txt"
HDY = "countries/vanilla/Hadiya.txt"
SOA = "countries/vanilla/Shewa.txt"
JJI = "countries/vanilla/Janjero.txt"
ABB = "countries/vanilla/Dongola.txt"
#Kongo, Great Lakes & Central Africa
TYO = "countries/vanilla/Tyo.txt"
SYO = "countries/vanilla/Soyo.txt"
KSJ = "countries/vanilla/Kasanje.txt"
LUB = "countries/vanilla/Luba.txt"
LND = "countries/vanilla/Lunda.txt"
CKW = "countries/vanilla/Chokwe.txt"
KIK = "countries/vanilla/Kikondja.txt"
KZB = "countries/vanilla/Kazembe.txt"
YAK = "countries/vanilla/Yaka.txt"
KLD = "countries/vanilla/Kalundwe.txt"
KUB = "countries/vanilla/Kuba.txt"
RWA = "countries/vanilla/Rwanda.txt"
BUU = "countries/vanilla/Burundi.txt"
BUG = "countries/vanilla/Buganda.txt"
NKO = "countries/vanilla/Nkore.txt"
KRW = "countries/vanilla/Karagwe.txt"
BNY = "countries/vanilla/Bunyoro.txt"
BSG = "countries/vanilla/Basoga.txt"
UBH = "countries/vanilla/Buha.txt"
MRA = "countries/vanilla/Maravi.txt"
LDU = "countries/vanilla/Lundu.txt"
TBK = "countries/vanilla/Tumbuka.txt"
MKU = "countries/vanilla/Makua.txt"
RZW = "countries/vanilla/Butua.txt"
#Madagascar
MIR = "countries/vanilla/Merina.txt"#And Betsileo
SKA = "countries/vanilla/Sakalava.txt"#All Sakalava Kingdoms
BTS = "countries/vanilla/Betsimisaraka.txt"#And their predecessors
MFY = "countries/vanilla/Mahafaly.txt"
ANT = "countries/vanilla/Antemoro.txt"
#Far East
ANN = "countries/vanilla/Annam.txt"
ARK = "countries/vanilla/Arakan.txt"
ATJ = "countries/vanilla/Atjeh.txt"
AYU = "countries/vanilla/Ayutthaya.txt"
BLI = "countries/vanilla/Bali.txt"
BAN = "countries/vanilla/Banten.txt"
BEI = "countries/vanilla/Brunei.txt"
CHA = "countries/vanilla/Champa.txt"
CHG = "countries/vanilla/ChagataiKhanate.txt"
CHK = "countries/vanilla/Champassak.txt"
DAI = "countries/vanilla/DaiViet.txt"
JAP = "countries/vanilla/Japan.txt"
#Daimyos
AMA = "countries/vanilla/Amago.txt"
ASA = "countries/vanilla/Asakura.txt"
CSK = "countries/vanilla/Chosokabe.txt"
DTE = "countries/vanilla/Date.txt"
HJO = "countries/vanilla/Hojo.txt"
HSK = "countries/vanilla/Hosokawa.txt"
HTK = "countries/vanilla/Hatakeyama.txt"
IKE = "countries/vanilla/Ikeda.txt"
IMG = "countries/vanilla/Imagawa.txt"
MAE = "countries/vanilla/Maeda.txt"
MRI = "countries/vanilla/Mori.txt"
ODA = "countries/vanilla/Oda.txt"
OTM = "countries/vanilla/Otomo.txt"
OUC = "countries/vanilla/Ouchi.txt"
SBA = "countries/vanilla/Shiba.txt"
SMZ = "countries/vanilla/Shimazu.txt"
TKD = "countries/vanilla/Takeda.txt"
TKG = "countries/vanilla/Tokugawa.txt"
UES = "countries/vanilla/Uesugi.txt"
YMN = "countries/vanilla/Yamana.txt"
RFR = "countries/vanilla/Nanbu.txt"
ASK = "countries/vanilla/Ashikaga.txt"
KTB = "countries/vanilla/Kitabatake.txt"
ANU = "countries/vanilla/Ainu.txt"
#New Daimyos 1.20
AKM = "countries/vanilla/Akamatsu.txt"
AKT = "countries/vanilla/Ando.txt"
CBA = "countries/vanilla/Chiba.txt"
ISK = "countries/vanilla/Isshiki.txt"
ITO = "countries/vanilla/Ito.txt"
KKC = "countries/vanilla/Kikuchi.txt"
KNO = "countries/vanilla/Kono.txt"
OGS = "countries/vanilla/Ogasawara.txt"
SHN = "countries/vanilla/Shoni.txt"
STK = "countries/vanilla/Satake.txt"
TKI = "countries/vanilla/Toki.txt"
UTN = "countries/vanilla/Utsunomiya.txt"
TTI = "countries/vanilla/Tsutsui.txt"
KHA = "countries/vanilla/MongolKhanate.txt"
KHM = "countries/vanilla/Khmer.txt"
KOR = "countries/vanilla/Korea.txt"
LNA = "countries/vanilla/LanNa.txt"
LUA = "countries/vanilla/LuangPrabang.txt"
LXA = "countries/vanilla/LanXang.txt"
MAJ = "countries/vanilla/Majapahit.txt"
MCH = "countries/vanilla/Manchu.txt"
MKS = "countries/vanilla/Makassar.txt"
MLC = "countries/vanilla/Malacca.txt"
MNG = "countries/vanilla/Ming.txt"
MTR = "countries/vanilla/Mataram.txt"
OIR = "countries/vanilla/OiratHorde.txt"
PAT = "countries/vanilla/Pattani.txt"
PEG = "countries/vanilla/Pegu.txt"
QNG = "countries/vanilla/Qing.txt"
RYU = "countries/vanilla/Ryukyu.txt"
SST = "countries/vanilla/Shan.txt"
SUK = "countries/vanilla/Sukhothai.txt"
SUL = "countries/vanilla/Sulu.txt"
TAU = "countries/vanilla/Taungu.txt"
TIB = "countries/vanilla/Tibet.txt"
TOK = "countries/vanilla/Tonkin.txt"
VIE = "countries/vanilla/Vientiane.txt"
CZH = "countries/vanilla/Zhou.txt"
CSH = "countries/vanilla/Shun.txt"
CXI = "countries/vanilla/Xi.txt"
YUA = "countries/vanilla/GreatYuan.txt"
FRM = "countries/vanilla/Formosa.txt"
# 1.27 steppe tags
ILK = "countries/vanilla/Ilkhanate.txt"
KLM = "countries/vanilla/Kalmyk.txt"
MGE = "countries/vanilla/MongolEmpire.txt"
# 1.29 new tags
SOO = "countries/vanilla/So.txt"# Japanese potential pirate daimyo
NVK = "countries/vanilla/Nivkh.txt"# Split from Yeren
SOL = "countries/vanilla/Solon.txt"# Split from Yeren
EJZ = "countries/vanilla/EastJianzhou.txt"# Split from Jianzhou
NHX = "countries/vanilla/NorthHaixi.txt"#Manchuria tags
MYR = "countries/vanilla/Yeren.txt"
MHX = "countries/vanilla/Haixi.txt"
MJZ = "countries/vanilla/Jianzhou.txt"
#Mongol tags
KRC = "countries/vanilla/Khorchin.txt"
KLK = "countries/vanilla/Khalkha.txt"
HMI = "countries/vanilla/Karadel.txt"
ZUN = "countries/vanilla/Zunghar.txt"
KAS = "countries/vanilla/Yarkand.txt"
CHH = "countries/vanilla/Chahar.txt"
#Great Tibet tags
KSD = "countries/vanilla/Khoshuud.txt"
SYG = "countries/vanilla/Sarigyogir.txt"
UTS = "countries/vanilla/Utsang.txt"
KAM = "countries/vanilla/Mdokhams.txt"
GUG = "countries/vanilla/Guge.txt"
PHA = "countries/vanilla/Phagmodrupa.txt"
#Non-Han China proper tags
CDL = "countries/vanilla/Dali.txt"
CYI = "countries/vanilla/Yi.txt"
CMI = "countries/vanilla/Miao.txt"
#Chinese Revolters
MIN = "countries/vanilla/Min.txt"
YUE = "countries/vanilla/Yue.txt"
SHU = "countries/vanilla/Shu.txt"
NNG = "countries/vanilla/Ning.txt"
CHC = "countries/vanilla/Chu.txt"
TNG = "countries/vanilla/Tang.txt"
WUU = "countries/vanilla/Wu.txt"
QIC = "countries/vanilla/Qi.txt"
YAN = "countries/vanilla/Yan.txt"
JIN = "countries/vanilla/Jin.txt"
LNG = "countries/vanilla/Liang.txt"
QIN = "countries/vanilla/Qin.txt"
HUA = "countries/vanilla/Huai.txt"
CGS = "countries/vanilla/Changsheng.txt"
#India
BAL = "countries/vanilla/Baluchistan.txt"
BNG = "countries/vanilla/Bengal.txt"
BIJ = "countries/vanilla/Bijapur.txt"
BAH = "countries/vanilla/Bahmanis.txt"
DLH = "countries/vanilla/Delhi.txt"
GOC = "countries/vanilla/Golconda.txt"
DEC = "countries/vanilla/Deccan.txt"
MAR = "countries/vanilla/Marathas.txt"
MUG = "countries/vanilla/Mughal.txt"
MYS = "countries/vanilla/Mysore.txt"
VIJ = "countries/vanilla/Vijaynagara.txt"
AHM = "countries/vanilla/Ahmadnagar.txt"
ASS = "countries/vanilla/Assam.txt"
GUJ = "countries/vanilla/Gujarat.txt"
JNP = "countries/vanilla/Jaunpur.txt"
MAD = "countries/vanilla/Madurai.txt"
MLW = "countries/vanilla/Malwa.txt"
MAW = "countries/vanilla/Marwar.txt"
MER = "countries/vanilla/Mewar.txt"
MUL = "countries/vanilla/Multan.txt"
NAG = "countries/vanilla/Nagpur.txt"
NPL = "countries/vanilla/Nepal.txt"
ORI = "countries/vanilla/Orissa.txt"
PUN = "countries/vanilla/Punjab.txt"
SND = "countries/vanilla/Sind.txt"
BRR = "countries/vanilla/Berar.txt"
JAN = "countries/vanilla/Jangladesh.txt"
KRK = "countries/vanilla/Carnatic.txt"
GDW = "countries/vanilla/Gondwana.txt"
GRJ = "countries/vanilla/Garjat.txt"
GWA = "countries/vanilla/Gwalior.txt"
DHU = "countries/vanilla/Dhundhar.txt"
KSH = "countries/vanilla/Kashmir.txt"
KLN = "countries/vanilla/Keladi.txt"
KHD = "countries/vanilla/Khandesh.txt"
ODH = "countries/vanilla/Oudh.txt"
VND = "countries/vanilla/Venad.txt"
MAB = "countries/vanilla/Malabar.txt"
MEW = "countries/vanilla/Mewat.txt"
BDA = "countries/vanilla/Baroda.txt"
BST = "countries/vanilla/Bastar.txt"
BHU = "countries/vanilla/Bhutan.txt"
BND = "countries/vanilla/Bundelkhand.txt"
CEY = "countries/vanilla/Ceylon.txt"
JSL = "countries/vanilla/Jaisalmer.txt"
KAC = "countries/vanilla/Kachar.txt"
KMT = "countries/vanilla/Koch.txt"
KGR = "countries/vanilla/Kangra.txt"
KAT = "countries/vanilla/Kathiawar.txt"
KOC = "countries/vanilla/Kochin.txt"
MLB = "countries/vanilla/Manipur.txt"
HAD = "countries/vanilla/Hadoti.txt"
NGA = "countries/vanilla/Nagaur.txt"
RMP = "countries/vanilla/Rohilkandh.txt"
LDK = "countries/vanilla/Ladakh.txt"
BGL = "countries/vanilla/Bagelkhand.txt"
JFN = "countries/vanilla/Jaffna.txt"
PTA = "countries/vanilla/Patiala.txt"
GHR = "countries/vanilla/Garhwal.txt"
CHD = "countries/vanilla/Chanda.txt"
NGP = "countries/vanilla/Jharkhand.txt"
JAJ = "countries/vanilla/Janjira.txt"
TRT = "countries/vanilla/Tirhut.txt"
CMP = "countries/vanilla/RewaKantha.txt"
BGA = "countries/vanilla/Baglana.txt"
TPR = "countries/vanilla/Tripura.txt"
SDY = "countries/vanilla/Sadiya.txt"
BHA = "countries/vanilla/Bharat.txt"
YOR = "countries/vanilla/Andhra.txt"
DGL = "countries/vanilla/Maldives.txt"
MBL = "countries/vanilla/Bishnupur.txt"
SKK = "countries/vanilla/Sikkim.txt"
IDR = "countries/vanilla/Idar.txt"
JLV = "countries/vanilla/Jhalavad.txt"
PTL = "countries/vanilla/Palitana.txt"
NVR = "countries/vanilla/Navanagar.txt"
RJK = "countries/vanilla/Rajkot.txt"
JGD = "countries/vanilla/Junagarh.txt"
PRB = "countries/vanilla/Porbandar.txt"
PAN = "countries/vanilla/Panna.txt"
KLP = "countries/vanilla/Kalpi.txt"
SBP = "countries/vanilla/Sambalpur.txt"
PTT = "countries/vanilla/Patna.txt"
RTT = "countries/vanilla/Ratanpur.txt"
KLH = "countries/vanilla/Kalahandi.txt"
KJH = "countries/vanilla/Keonhjar.txt"
PRD = "countries/vanilla/Parlakhimidi.txt"
JPR = "countries/vanilla/Jeypore.txt"
SRG = "countries/vanilla/Surguja.txt"
KND = "countries/vanilla/Kandy.txt"
TLG = "countries/vanilla/Telingana.txt"
KLT = "countries/vanilla/Kolathunad.txt"
DNG = "countries/vanilla/Dang.txt"
DTI = "countries/vanilla/Doti.txt"
GRK = "countries/vanilla/Gorkha.txt"
JML = "countries/vanilla/Jumla.txt"
LWA = "countries/vanilla/Limbuwan.txt"
MKP = "countries/vanilla/Makwanpur.txt"
SRM = "countries/vanilla/Sirmur.txt"
KTU = "countries/vanilla/Kathmandu.txt"
KMN = "countries/vanilla/Kumaon.txt"
GNG = "countries/vanilla/Gingee.txt"
TNJ = "countries/vanilla/Tanjore.txt"
SRH = "countries/vanilla/Sirhind.txt"
RJP = "countries/vanilla/Rajputana.txt"
BAR = "countries/vanilla/Bar.txt"
HSA = "countries/vanilla/Hansa.txt"
SMO = "countries/vanilla/Smolensk.txt"
NZH = "countries/vanilla/NizhnyNovgorod.txt"
KOJ = "countries/vanilla/Jerusalem.txt"
MSA = "countries/vanilla/Malaya.txt"
HIN = "countries/vanilla/Hindustan.txt"
ABE = "countries/vanilla/Abenaki.txt"
APA = "countries/vanilla/Apache.txt"
ASI = "countries/vanilla/Assiniboine.txt"
BLA = "countries/vanilla/Blackfoot.txt"
CAD = "countries/vanilla/Caddo.txt"
CHI = "countries/vanilla/Chickasaw.txt"
CHO = "countries/vanilla/Choctaw.txt"
CHY = "countries/vanilla/Cheyenne.txt"
COM = "countries/vanilla/Comanche.txt"
FOX = "countries/vanilla/Fox.txt"
ILL = "countries/vanilla/Illinewek.txt"
LEN = "countries/vanilla/Lenape.txt"
MAH = "countries/vanilla/Mahican.txt"
MIK = "countries/vanilla/Mikmaq.txt"
MMI = "countries/vanilla/Miami.txt"
NAH = "countries/vanilla/Navajo.txt"
OJI = "countries/vanilla/Ojibwa.txt"
OSA = "countries/vanilla/Osage.txt"
OTT = "countries/vanilla/Ottawa.txt"
PAW = "countries/vanilla/Pawnee.txt"
PEQ = "countries/vanilla/Pequot.txt"
PIM = "countries/vanilla/Pima.txt"
POT = "countries/vanilla/Potawatomi.txt"
POW = "countries/vanilla/Powhatan.txt"
PUE = "countries/vanilla/Pueblo.txt"
SHO = "countries/vanilla/Shoshone.txt"
SIO = "countries/vanilla/Sioux.txt"
SUS = "countries/vanilla/Susquehannock.txt"
WCR = "countries/vanilla/Cree.txt"
#African Additions
AIR = "countries/vanilla/Air.txt"
BON = "countries/vanilla/Bonoman.txt"
DAH = "countries/vanilla/Dahomey.txt"
DGB = "countries/vanilla/Dagbon.txt"
FUL = "countries/vanilla/Fulo.txt"
JNN = "countries/vanilla/Jenne.txt"
KAN = "countries/vanilla/Kano.txt"
KBU = "countries/vanilla/Kaabu.txt"
KNG = "countries/vanilla/Kong.txt"
KTS = "countries/vanilla/Katsina.txt"
MSI = "countries/vanilla/Mossi.txt"
NUP = "countries/vanilla/Nupe.txt"
TMB = "countries/vanilla/Timbuktu.txt"
YAO = "countries/vanilla/Yao.txt"
YAT = "countries/vanilla/Yatenga.txt"
ZAF = "countries/vanilla/Zafunu.txt"
ZZZ = "countries/vanilla/Zazzau.txt"
NDO = "countries/vanilla/Ndongo.txt"
#Indochina Additions
AVA = "countries/vanilla/Ava.txt"
HSE = "countries/vanilla/Hsenwi.txt"
JOH = "countries/vanilla/Johor.txt"
KED = "countries/vanilla/Kedah.txt"
LIG = "countries/vanilla/Ligor.txt"
MPH = "countries/vanilla/MuanPhuang.txt"
MYA = "countries/vanilla/MongYang.txt"
PRK = "countries/vanilla/Perak.txt"
# Burma Additions
MMA = "countries/vanilla/MongMao.txt"
MKA = "countries/vanilla/MongKawng.txt"
MPA = "countries/vanilla/MongPai.txt"
MNI = "countries/vanilla/MongNai.txt"
KAL = "countries/vanilla/Kale.txt"
HSI = "countries/vanilla/Hsipaw.txt"
BPR = "countries/vanilla/Prome.txt"
#Siberian Tribes
CHU = "countries/vanilla/Chukchi.txt"
HOD = "countries/vanilla/Hodyntsy.txt"
CHV = "countries/vanilla/Chavchuveny.txt"
KMC = "countries/vanilla/Kamchadals.txt"
BRT = "countries/vanilla/Buryats.txt"
#North American Additions
ARP = "countries/vanilla/Arapaho.txt"
CLM = "countries/vanilla/Colima.txt"
CNK = "countries/vanilla/Chinook.txt"
COC = "countries/vanilla/Cocomes.txt"
HDA = "countries/vanilla/Haida.txt"
ITZ = "countries/vanilla/Itza.txt"
KIC = "countries/vanilla/Kiche.txt"
KIO = "countries/vanilla/Kiowa.txt"
MIX = "countries/vanilla/Mixtec.txt"
SAL = "countries/vanilla/Salish.txt"
TAR = "countries/vanilla/Tarascan.txt"
TLA = "countries/vanilla/Tlapanec.txt"
TLX = "countries/vanilla/Tlaxcala.txt"
TOT = "countries/vanilla/Totonac.txt"
WIC = "countries/vanilla/Wichita.txt"
XIU = "countries/vanilla/Xiu.txt"
#Indonesia Additions
BLM = "countries/vanilla/Blambangan.txt"
BTN = "countries/vanilla/Buton.txt"
CRB = "countries/vanilla/Cirebon.txt"
DMK = "countries/vanilla/Demak.txt"
PGR = "countries/vanilla/Pagarruyung.txt"
PLB = "countries/vanilla/Palembang.txt"
PSA = "countries/vanilla/Pasai.txt"
SAK = "countries/vanilla/Siak.txt"
SUN = "countries/vanilla/Sunda.txt"
KUT = "countries/vanilla/Kutai.txt"
BNJ = "countries/vanilla/Banjar.txt"
LFA = "countries/vanilla/Lanfang.txt"
LNO = "countries/vanilla/Lanao.txt"
LUW = "countries/vanilla/Luwu.txt"
MGD = "countries/vanilla/Maguindanao.txt"
TER = "countries/vanilla/Ternate.txt"
TID = "countries/vanilla/Tidore.txt"
MAS = "countries/vanilla/Madyaas.txt"
PGS = "countries/vanilla/Pangasinan.txt"
TDO = "countries/vanilla/Tondo.txt"
MNA = "countries/vanilla/Maynila.txt"
CEB = "countries/vanilla/Cebu.txt"
BTU = "countries/vanilla/Butuan.txt"
#South American Additions
CSU = "countries/vanilla/Cusco.txt"
CCQ = "countries/vanilla/Calchaqui.txt"
MPC = "countries/vanilla/Mapuche.txt"
MCA = "countries/vanilla/Muisca.txt"
QTO = "countries/vanilla/Quito.txt"
CJA = "countries/vanilla/Cajamarca.txt"
HJA = "countries/vanilla/Huyla.txt"
PTG = "countries/vanilla/Potiguara.txt"
TPQ = "countries/vanilla/Tupiniquim.txt"
TPA = "countries/vanilla/Tupinamba.txt"
TUA = "countries/vanilla/Tapuia.txt"
GUA = "countries/vanilla/Guarani.txt"
CUA = "countries/vanilla/Charrua.txt"
WKA = "countries/vanilla/Wanka.txt"
CYA = "countries/vanilla/Chachapoya.txt"
CLA = "countries/vanilla/Colla.txt"
CRA = "countries/vanilla/Charca.txt"
PCJ = "countries/vanilla/Pacajes.txt"
ARW = "countries/vanilla/Arawak.txt"
CAB = "countries/vanilla/Carib.txt"
ICM = "countries/vanilla/Ichma.txt"
#Golden Century Mesoamerican Tags
MAT = "countries/vanilla/Matlatzinca.txt"
COI = "countries/vanilla/Coixtlahuaca.txt"
TEO = "countries/vanilla/Teotitlan.txt"
XAL = "countries/vanilla/Xalisco.txt"
GAM = "countries/vanilla/Guamar.txt"
HST = "countries/vanilla/Huastec.txt"
CCM = "countries/vanilla/Chichimeca.txt"
OTO = "countries/vanilla/Otomi.txt"
YOK = "countries/vanilla/Yokotan.txt"
LAC = "countries/vanilla/Lacandon.txt"
KAQ = "countries/vanilla/Kaqchikel.txt"
CTM = "countries/vanilla/Chactemal.txt"
KER = "countries/vanilla/Keres.txt"
ZNI = "countries/vanilla/Zuni.txt"
MSC = "countries/vanilla/Mescalero.txt"
LIP = "countries/vanilla/Lipan.txt"
CHT = "countries/vanilla/Chorti.txt"
MIS = "countries/vanilla/Miskito.txt"
TAI = "countries/vanilla/Tairona.txt"
CNP = "countries/vanilla/Can Pech.txt"
TON = "countries/vanilla/Tonallan.txt"
YAQ = "countries/vanilla/Yaqui.txt"
YKT = "countries/vanilla/Yokuts.txt"
# Pirate tags
NSS = "countries/vanilla/New Providence.txt"
PRY = "countries/vanilla/Port Royal.txt"
TOR = "countries/vanilla/Tortuga.txt"
LIB = "countries/vanilla/Libertatia.txt"
# 1.30 New Tags
UBV = "countries/vanilla/Munich.txt"
LBV = "countries/vanilla/Landshut.txt"
ING = "countries/vanilla/Ingolstadt.txt"
PSS = "countries/vanilla/Passau.txt"
MBZ = "countries/vanilla/Montfort-Bregenz.txt"
KNZ = "countries/vanilla/Konstanz.txt"
ROT = "countries/vanilla/Rothenburg.txt"
BYT = "countries/vanilla/Bayreuth.txt"
REG = "countries/vanilla/Regensburg.txt"
GNV = "countries/vanilla/Geneva.txt"
TTL = "countries/vanilla/Three Leagues.txt"
OPL = "countries/vanilla/Opole.txt"
GLG = "countries/vanilla/Glogau.txt"
BLG = "countries/vanilla/Bologna.txt"
PDV = "countries/vanilla/Padova.txt"
SZO = "countries/vanilla/Saluzzo.txt"
SPL = "countries/vanilla/Spoleto.txt"
WOL = "countries/vanilla/Wolgast.txt"
STE = "countries/vanilla/Stettin.txt"
GOS = "countries/vanilla/Goslar.txt"
SOR = "countries/vanilla/Sorbia.txt"
RUG = "countries/vanilla/Rugen.txt"
CLI = "countries/vanilla/Cilli.txt"
HRZ = "countries/vanilla/Herzegovina.txt"
TNT = "countries/vanilla/Trent.txt"
BRG = "countries/vanilla/Berg.txt"
MLH = "countries/vanilla/Mulhouse.txt"
BAM = "countries/vanilla/Bamberg.txt"
RUP = "countries/vanilla/Ruppin.txt"
LPP = "countries/vanilla/Lippe.txt"
PAD = "countries/vanilla/Paderborn.txt"
CLB = "countries/vanilla/Calenberg.txt"
DWT = "countries/vanilla/Donauwoerth.txt"
OSN = "countries/vanilla/Osnabruck.txt"
VRN = "countries/vanilla/Verona.txt"
COB = "countries/vanilla/Coburg.txt"
LOT = "countries/vanilla/Lotharingia.txt"
PGA = "countries/vanilla/Perugia.txt"
# 1.30 Formables
TTS = "countries/vanilla/Two Sicilies.txt"
FKN = "countries/vanilla/Franconia.txt"
SWA = "countries/vanilla/Swabia.txt"
# Leviathan New Tags
BNE = "countries/vanilla/Bone.txt"
BEU = "countries/vanilla/Berau.txt"
SMB = "countries/vanilla/Sambas.txt"
BRS = "countries/vanilla/Barus.txt"
DLI = "countries/vanilla/Deli.txt"
JMB = "countries/vanilla/Jambi.txt"
PAH = "countries/vanilla/Pahang.txt"
KEL = "countries/vanilla/Kelantan.txt"
IND = "countries/vanilla/Indrapura.txt"
JAR = "countries/vanilla/Jarai.txt"
RHA = "countries/vanilla/Rhade.txt"
KOH = "countries/vanilla/Koho.txt"
SIA = "countries/vanilla/Siam.txt"
# Leviathan Australian tags
TIW = "countries/vanilla/Tiwi.txt"
LAR = "countries/vanilla/Larrakia.txt"
YOL = "countries/vanilla/Yolngu.txt"
YNU = "countries/vanilla/Yanuwa.txt"
AWN = "countries/vanilla/Awngthim.txt"
GMI = "countries/vanilla/Gamilaraay.txt"
MIA = "countries/vanilla/Mianjin.txt"
EOR = "countries/vanilla/Eora.txt"
KUL = "countries/vanilla/Kulin.txt"
KAU = "countries/vanilla/Kaurna.txt"
PLW = "countries/vanilla/Palawa.txt"
WRU = "countries/vanilla/Wurundjeri.txt"
NOO = "countries/vanilla/Noongar.txt"
MLG = "countries/vanilla/Malagana.txt"
# Leviathan Maori tags
AOT = "countries/vanilla/Aotearoa.txt"
MAA = "countries/vanilla/Mataatua.txt"
TAN = "countries/vanilla/Tainui.txt"
TAK = "countries/vanilla/Takitimu.txt"
TNK = "countries/vanilla/Taranaki.txt"
TEA = "countries/vanilla/TeArawa.txt"
TTT = "countries/vanilla/TeTaiTokerau.txt"
WAI = "countries/vanilla/Waitaha.txt"
# Leviathan Oceanic tags
UHW = "countries/vanilla/HawaiiUnited.txt"
HAW = "countries/vanilla/Hawaii.txt"
MAU = "countries/vanilla/Maui.txt"
OAH = "countries/vanilla/Oahu.txt"
KAA = "countries/vanilla/Kauai.txt"
TOG = "countries/vanilla/Tonga.txt"
SAM = "countries/vanilla/Samoa.txt"
VIT = "countries/vanilla/Viti.txt"
VIL = "countries/vanilla/Viti Levu.txt"
VNL = "countries/vanilla/Vanua Levu.txt"
LAI = "countries/vanilla/Lau.txt"
#North America Mississippians
ALT = "countries/vanilla/Altamaha.txt"
ICH = "countries/vanilla/Ichisi.txt"
COF = "countries/vanilla/Cofitachequi.txt"
JOA = "countries/vanilla/Joara.txt"
ETO = "countries/vanilla/Etowah.txt"
SAT = "countries/vanilla/Satapo.txt"
CIA = "countries/vanilla/Chiaha.txt"
COO = "countries/vanilla/Coosa.txt"
ABI = "countries/vanilla/Abihka.txt"
COW = "countries/vanilla/Coweta.txt"
NTZ = "countries/vanilla/Natchez.txt"
CAQ = "countries/vanilla/Casqui.txt"
PCH = "countries/vanilla/Pacaha.txt"
QUI = "countries/vanilla/Quizquiz.txt"
CCA = "countries/vanilla/Chisca.txt"
ATA = "countries/vanilla/Atahachi.txt"
KSI = "countries/vanilla/Kasihta.txt"
OEO = "countries/vanilla/Oneota.txt"
ANL = "countries/vanilla/Anilco.txt"
NTC = "countries/vanilla/Natchitoches.txt"
HNI = "countries/vanilla/Hasinai.txt"
#North American Iroquoians
MOH = "countries/vanilla/Mohawk.txt"
ONE = "countries/vanilla/Oneida.txt"
ONO = "countries/vanilla/Onondaga.txt"
CAY = "countries/vanilla/Cayuga.txt"
SEN = "countries/vanilla/Seneca.txt"
TAH = "countries/vanilla/Tahontaenrat.txt"
ATT = "countries/vanilla/Attignawantan.txt"
AGG = "countries/vanilla/Attigneenongnahac.txt"
ATW = "countries/vanilla/Attiwandaron.txt"
ARN = "countries/vanilla/Arendaronon.txt"
TIO = "countries/vanilla/Tionontate.txt"
OSH = "countries/vanilla/Osheaga.txt"
STA = "countries/vanilla/Stadacona.txt"
ERI = "countries/vanilla/Erie.txt"
WEN = "countries/vanilla/Wenro.txt"
TSC = "countries/vanilla/Tuscarora.txt"
#North American Pueblos
OHK = "countries/vanilla/Ohkay Owingeh.txt"
ISL = "countries/vanilla/Isleta.txt"
ACO = "countries/vanilla/Acoma.txt"
#North American Other Federations and Tags
CAO = "countries/vanilla/Cahokia.txt"
PEO = "countries/vanilla/Peoria.txt"
KSK = "countries/vanilla/Kaskaskia.txt"
PEN = "countries/vanilla/Penobscot.txt"
MLS = "countries/vanilla/Maliseet.txt"
NEH = "countries/vanilla/Nehiyaw.txt"
NAK = "countries/vanilla/Nakawe.txt"
HWK = "countries/vanilla/Hathawekela.txt"
CLG = "countries/vanilla/Chalahgawtha.txt"
KSP = "countries/vanilla/Kispoko.txt"
MSG = "countries/vanilla/Mississage.txt"
WCY = "countries/vanilla/Wichiyena.txt"
LAK = "countries/vanilla/Lakota.txt"
#North America Missing Tags for a good map
INN = "countries/vanilla/Innu.txt"
WAM = "countries/vanilla/Wampanoag.txt"
AGQ = "countries/vanilla/Algonquin.txt"
# ???
JMN = "countries/vanilla/Jan Mayen.txt"
ROM = "countries/vanilla/RomanEmpire.txt"
SYN = "countries/vanilla/Synthetics.txt"
#New Formables
ISR = "countries/vanilla/Israel.txt"
#Converter tags:
#JOM = countries/vanilla/Jomsvikings.txt
#HAH = countries/vanilla/Hashshashin.txt
#TEM = countries/vanilla/KnightsTemplar.txt
#TRL = countries/vanilla/Trapalanda.txt